1111111111111111111111111111111
1P01000001010000000000010000011
1010010100101111111011110111111
1000001000000001000000000001011
1010011111111110100101111011111
1010010100000000101000000001111
1010010111111111111111101001111
1010000010000010000010000010111
1011110100111111101001011111111
1010000010100000000101000001111
1111011110100111101001011111111
1000001000000E01000001010000011
1010011111110111111111111111111
1010010000010000010000000010111
1011110100101111111011110111111
100000101000C000000000000000011
1011110111101111111011110111111
1010000000010100000000101001111
1011110100101111111010010111111
100000000101000000001010000E111
1111111111111111111111111111111
