111111111111111111111111111111111111111111111111111111111111111111
10000P00000111111000X000000C000110000000000000C0000000000000000001
1000000000C0000110000000000000000000001100000000010000000000010001
10000000000000000000000000100000000001000000000001000000C000100001
11100000000000000000000000X000000000000000000001000000111000000001
1110000X000000111000000000000000000000000000C100000000111000000001
11000000000000111000000C000000000000000000000100000000000000000001
100000000000000C00000000000000000000000000000000000000000000000001
100001111100000000000000011000000000111110000000000000000110000001
111111000C10000000000000C00000000000100010000000000000000000000001
10000000001000000000000000000000000011111000000000C00000000X000001
1000X0000000000000000000000000000000C00000001100000000000000000001
10000000111111100000000000X000000000000000000000011111111100000001
1000000000000C100000000000000000000000000000000001X000C01100000001
100000000000001000000000000000011111110000000000110000000100000001
111111111111111000000000000000010000010000000000000000111100C00001
100000000000000000000000000000000000010000011000000000000000000001
1000C00000000000110000C000010000000000111110000001000000C0001000E1
111111111111111111111111111111111111111111111111111111111111111111
